xl_file,property_name,unit_type,excluded_units,rentable_units,avg_scheduled_charges,current_occupied,prior_total_new,current_total_new,prior_renewal,current_renewal,prior_total_leases,current_total_leases,prior_pre_lease_pct,current_pre_lease_pct,yoy_variance_pct,projected_availability
data-raw/data/original/pre_lease/Pre-Lease - 2024-06-05T144159.276.xlsx,1008 S. 4Th,B1,0,8,942.5,8,6,5,2,3,8,8,1,1,0,0
data-raw/data/original/pre_lease/Pre-Lease - 2024-06-05T144159.276.xlsx,1008 S. 4Th,B2,0,8,925,8,6,3,2,5,8,8,1,1,0,0
data-raw/data/original/pre_lease/Pre-Lease - 2024-06-05T144159.276.xlsx,1008 S. 4Th,B3,0,10,1059.5,10,9,6,1,4,10,10,1,1,0,0
data-raw/data/original/pre_lease/Pre-Lease - 2024-06-05T144159.276.xlsx,1008 S. 4Th,B4,0,2,1106.6666666666667,2,2,1,0,2,2,3,1,1.5,0.5,-1
data-raw/data/original/pre_lease/Pre-Lease - 2024-06-05T144159.276.xlsx,1008 S. 4Th,B5,0,2,1110,2,2,2,0,0,2,2,1,1,0,0
data-raw/data/original/pre_lease/Pre-Lease - 2024-06-05T144159.276.xlsx,1008 S. 4Th,C1,0,12,879.1666666666666,12,8,9,2,3,10,12,0.8333333333333334,1,0.16666666666666663,0
data-raw/data/original/pre_lease/Pre-Lease - 2024-06-05T144159.276.xlsx,1008 S. 4Th,D1,0,16,811.25,16,16,7,0,9,16,16,1,1,0,0
data-raw/data/original/pre_lease/Pre-Lease - 2024-06-05T144159.276.xlsx,1008 S. 4Th,D1 Balcony,0,16,804.375,16,15,12,0,4,15,16,0.9375,1,0.0625,0
data-raw/data/original/pre_lease/Pre-Lease - 2024-06-05T144159.276.xlsx,1008 S. 4Th,D2,0,48,875.2083333333334,46,39,32,8,16,47,48,0.9791666666666666,1,0.02083333333333337,0
data-raw/data/original/pre_lease/Pre-Lease - 2024-06-05T144159.276.xlsx,1008 S. 4Th,D3 Balcony,0,12,944.1666666666666,12,12,10,0,2,12,12,1,1,0,0
data-raw/data/original/pre_lease/Pre-Lease - 2024-06-05T144159.276.xlsx,1008 S. 4Th,M1 Murphy,0,4,1085,2,3,3,1,1,4,4,1,1,0,0
data-raw/data/original/pre_lease/Pre-Lease - 2024-06-05T144159.276.xlsx,1008 S. 4Th,M1 Murphy Balcony,0,12,1180.8333333333333,9,9,10,2,2,11,12,0.9166666666666666,1,0.08333333333333337,0
data-raw/data/original/pre_lease/Pre-Lease - 2024-06-05T144159.276.xlsx,1008 S. 4Th,Not Selected,0,0,0,0,0,0,0,0,0,0,0,0,0,0
data-raw/data/original/pre_lease/Pre-Lease - 2024-06-05T144159.276.xlsx,1008 S. 4Th,S1,0,4,1322.5,4,3,3,1,1,4,4,1,1,0,0
data-raw/data/original/pre_lease/Pre-Lease - 2024-06-05T144159.276.xlsx,1008 S. 4Th,S2,0,4,1267.5,4,2,2,2,2,4,4,1,1,0,0
data-raw/data/original/pre_lease/Pre-Lease - 2024-06-05T144159.276.xlsx,1047 Commonwealth Avenue,Not Selected,0,0,0,0,0,0,0,0,0,0,0,0,0,0
data-raw/data/original/pre_lease/Pre-Lease - 2024-06-05T144159.276.xlsx,1047 Commonwealth Avenue,S1,0,25,2783,25,12,13,13,12,25,25,1,1,0,0
data-raw/data/original/pre_lease/Pre-Lease - 2024-06-05T144159.276.xlsx,1047 Commonwealth Avenue,S2,0,12,2923.75,11,7,6,4,6,11,12,0.9166666666666666,1,0.08333333333333337,0
data-raw/data/original/pre_lease/Pre-Lease - 2024-06-05T144159.276.xlsx,1047 Commonwealth Avenue,S3,0,51,3001.1290322580644,51,28,16,20,15,48,31,0.9411764705882353,0.6078431372549019,-0.33333333333333337,20
data-raw/data/original/pre_lease/Pre-Lease - 2024-06-05T144159.276.xlsx,1047 Commonwealth Avenue,S4,0,8,2619.4444444444443,8,6,5,2,4,8,9,1,1.125,0.125,-1
data-raw/data/original/pre_lease/Pre-Lease - 2024-06-05T144159.276.xlsx,1047 Commonwealth Avenue,S5,0,10,3081,10,5,6,3,4,8,10,0.8,1,0.19999999999999996,0
data-raw/data/original/pre_lease/Pre-Lease - 2024-06-05T144159.276.xlsx,1047 Commonwealth Avenue,S6,0,29,3267.8571428571427,29,17,18,11,10,28,28,0.9655172413793104,0.9655172413793104,0,1
data-raw/data/original/pre_lease/Pre-Lease - 2024-06-05T144159.276.xlsx,1047 Commonwealth Avenue,S7,0,4,3337.5,4,3,2,1,2,4,4,1,1,0,0
data-raw/data/original/pre_lease/Pre-Lease - 2024-06-05T144159.276.xlsx,1047 Commonwealth Avenue,S8,0,11,3381.6666666666665,11,0,0,6,3,6,3,0.5454545454545454,0.2727272727272727,-0.2727272727272727,8
data-raw/data/original/pre_lease/Pre-Lease - 2024-06-05T144159.276.xlsx,1047 Commonwealth Avenue,S9,0,5,3950,5,3,2,2,0,5,2,1,0.4,-0.6,3
data-raw/data/original/pre_lease/Pre-Lease - 2024-06-05T144159.276.xlsx,1047 Commonwealth Avenue,S10,0,4,4047.5,4,1,0,1,2,2,2,0.5,0.5,0,2
data-raw/data/original/pre_lease/Pre-Lease - 2024-06-05T144159.276.xlsx,1047 Commonwealth Avenue,S11,0,24,935,24,5,6,2,8,7,14,0.2916666666666667,0.5833333333333334,0.2916666666666667,10
data-raw/data/original/pre_lease/Pre-Lease - 2024-06-05T144159.276.xlsx,307 E. Daniel,D1,0,40,959.6153846153846,40,34,23,5,16,39,39,0.975,0.975,0,1
data-raw/data/original/pre_lease/Pre-Lease - 2024-06-05T144159.276.xlsx,501 S. 6Th,B1,0,2,895,2,2,0,0,2,2,2,1,1,0,0
data-raw/data/original/pre_lease/Pre-Lease - 2024-06-05T144159.276.xlsx,501 S. 6Th,B2,0,2,915,2,2,0,0,2,2,2,1,1,0,0
data-raw/data/original/pre_lease/Pre-Lease - 2024-06-05T144159.276.xlsx,501 S. 6Th,C1,0,12,931.6666666666666,12,9,12,3,0,12,12,1,1,0,0
data-raw/data/original/pre_lease/Pre-Lease - 2024-06-05T144159.276.xlsx,501 S. 6Th,C2,0,12,966.25,12,12,9,0,3,12,12,1,1,0,0
data-raw/data/original/pre_lease/Pre-Lease - 2024-06-05T144159.276.xlsx,501 S. 6Th,D1,0,16,706.875,16,16,3,0,13,16,16,1,1,0,0
data-raw/data/original/pre_lease/Pre-Lease - 2024-06-05T144159.276.xlsx,501 S. 6Th,D2,0,16,711.25,16,5,8,11,8,16,16,1,1,0,0
data-raw/data/original/pre_lease/Pre-Lease - 2024-06-05T144159.276.xlsx,501 S. 6Th,D3 Townhome,0,4,825,4,1,4,2,0,3,4,0.75,1,0.25,0
data-raw/data/original/pre_lease/Pre-Lease - 2024-06-05T144159.276.xlsx,501 S. 6Th,E1 Townhome,0,20,791.5,20,15,8,3,12,18,20,0.9,1,0.09999999999999998,0
data-raw/data/original/pre_lease/Pre-Lease - 2024-06-05T144159.276.xlsx,501 S. 6Th,E2 Townhome,0,20,812.6315789473684,19,11,5,5,14,16,19,0.8,0.95,0.1499999999999999,1
data-raw/data/original/pre_lease/Pre-Lease - 2024-06-05T144159.276.xlsx,908 S. 1St,A1,0,16,1385.9375,15,10,12,4,4,14,16,0.875,1,0.125,0
data-raw/data/original/pre_lease/Pre-Lease - 2024-06-05T144159.276.xlsx,908 S. 1St,B1,0,8,874.375,8,7,6,0,2,7,8,0.875,1,0.125,0
data-raw/data/original/pre_lease/Pre-Lease - 2024-06-05T144159.276.xlsx,908 S. 1St,B2,0,16,886.25,16,14,10,2,6,16,16,1,1,0,0
data-raw/data/original/pre_lease/Pre-Lease - 2024-06-05T144159.276.xlsx,908 S. 1St,B3,0,8,981.875,7,8,6,0,2,8,8,1,1,0,0
data-raw/data/original/pre_lease/Pre-Lease - 2024-06-05T144159.276.xlsx,908 S. 1St,D1,0,16,853.75,16,13,6,0,10,13,16,0.8125,1,0.1875,0
data-raw/data/original/pre_lease/Pre-Lease - 2024-06-05T144159.276.xlsx,908 S. 1St,M1 Murphy,0,12,1071.6666666666667,10,9,7,2,5,11,12,0.9166666666666666,1,0.08333333333333337,0
data-raw/data/original/pre_lease/Pre-Lease - 2024-06-05T144159.276.xlsx,908 S. 1St,M1 Murphy Balcony,0,16,1111.875,16,9,11,6,5,15,16,0.9375,1,0.0625,0
data-raw/data/original/pre_lease/Pre-Lease - 2024-06-05T144159.276.xlsx,908 S. 1St,M2 Murphy,0,4,1125,4,2,4,2,0,4,4,1,1,0,0
data-raw/data/original/pre_lease/Pre-Lease - 2024-06-05T144159.276.xlsx,908 S. 1St,Not Selected,0,0,0,0,0,0,0,0,0,0,0,0,0,0
data-raw/data/original/pre_lease/Pre-Lease - 2024-06-05T144159.276.xlsx,Academy 65,A1,0,10,1863.4,10,2,2,7,8,9,10,0.9,1,0.09999999999999998,0
data-raw/data/original/pre_lease/Pre-Lease - 2024-06-05T144159.276.xlsx,Academy 65,B1,0,21,1023.4171428571428,21,18,13,4,8,22,21,1.0476190476190477,1,-0.04761904761904767,0
data-raw/data/original/pre_lease/Pre-Lease - 2024-06-05T144159.276.xlsx,Academy 65,B1 Semi-Shared,0,21,864.8235294117648,20,6,12,10,5,16,17,0.7619047619047619,0.8095238095238095,0.04761904761904767,4
data-raw/data/original/pre_lease/Pre-Lease - 2024-06-05T144159.276.xlsx,Academy 65,C1 Study,0,3,1071.6666666666667,2,1,3,1,0,2,3,0.6666666666666666,1,0.33333333333333337,0
data-raw/data/original/pre_lease/Pre-Lease - 2024-06-05T144159.276.xlsx,Academy 65,D1 Balcony,0,40,950.48,33,11,7,8,5,19,12,0.475,0.3,-0.175,28
data-raw/data/original/pre_lease/Pre-Lease - 2024-06-05T144159.276.xlsx,Academy 65,D2,0,64,988.016888888889,61,13,21,28,24,41,45,0.640625,0.703125,0.0625,19
data-raw/data/original/pre_lease/Pre-Lease - 2024-06-05T144159.276.xlsx,Academy 65,D3,0,20,969.9444444444445,18,11,8,9,10,20,18,1,0.9,-0.09999999999999998,2
data-raw/data/original/pre_lease/Pre-Lease - 2024-06-05T144159.276.xlsx,Academy 65,D3 Semi-Shared,0,120,887.2978723404256,99,11,3,48,44,59,47,0.49166666666666664,0.39166666666666666,-0.09999999999999998,73
data-raw/data/original/pre_lease/Pre-Lease - 2024-06-05T144159.276.xlsx,Academy 65,Not Selected,0,0,0,0,0,0,0,0,0,0,0,0,0,0
data-raw/data/original/pre_lease/Pre-Lease - 2024-06-05T144159.276.xlsx,Academy 65,S1,0,5,1582.8,5,2,2,1,3,3,5,0.6,1,0.4,0
data-raw/data/original/pre_lease/Pre-Lease - 2024-06-05T144159.276.xlsx,Academy 65,S2,0,5,1596,5,3,1,1,4,4,5,0.8,1,0.19999999999999996,0
data-raw/data/original/pre_lease/Pre-Lease - 2024-06-05T144159.276.xlsx,Academy Lincoln,B1,0,30,864.3333333333334,30,23,16,5,14,28,30,0.9333333333333333,1,0.06666666666666665,0
data-raw/data/original/pre_lease/Pre-Lease - 2024-06-05T144159.276.xlsx,Academy Lincoln,B2,0,38,887.5,36,20,21,16,15,36,36,0.9473684210526315,0.9473684210526315,0,2
data-raw/data/original/pre_lease/Pre-Lease - 2024-06-05T144159.276.xlsx,Academy Lincoln,B3 Townhome,0,14,941.8571428571429,14,9,5,4,9,13,14,0.9285714285714286,1,0.0714285714285714,0
data-raw/data/original/pre_lease/Pre-Lease - 2024-06-05T144159.276.xlsx,Academy Lincoln,C1,0,42,826.9444444444445,41,24,29,14,7,38,36,0.9047619047619048,0.8571428571428571,-0.04761904761904767,6
data-raw/data/original/pre_lease/Pre-Lease - 2024-06-05T144159.276.xlsx,Academy Lincoln,D1,0,472,692.6608695652174,453,277,282,111,178,388,460,0.8220338983050848,0.9745762711864406,0.15254237288135586,12
data-raw/data/original/pre_lease/Pre-Lease - 2024-06-05T144159.276.xlsx,Academy Lincoln,D2,0,36,743.1428571428571,34,12,23,4,12,16,35,0.4444444444444444,0.9722222222222222,0.5277777777777778,1
data-raw/data/original/pre_lease/Pre-Lease - 2024-06-05T144159.276.xlsx,Academy Lincoln,Not Selected,0,0,0,0,0,0,0,0,0,0,0,0,0,0
data-raw/data/original/pre_lease/Pre-Lease - 2024-06-05T144159.276.xlsx,The Dean Campustown,A1,0,14,1963.2142857142858,14,10,5,4,9,14,14,1,1,0,0
data-raw/data/original/pre_lease/Pre-Lease - 2024-06-05T144159.276.xlsx,The Dean Campustown,A2 Deluxe,0,28,983.0357142857143,26,16,16,10,12,26,28,0.9285714285714286,1,0.0714285714285714,0
data-raw/data/original/pre_lease/Pre-Lease - 2024-06-05T144159.276.xlsx,The Dean Campustown,B1,0,28,1247.6785714285713,27,19,17,9,11,28,28,1,1,0,0
data-raw/data/original/pre_lease/Pre-Lease - 2024-06-05T144159.276.xlsx,The Dean Campustown,B2,0,28,1317.5,28,19,16,9,12,28,28,1,1,0,0
data-raw/data/original/pre_lease/Pre-Lease - 2024-06-05T144159.276.xlsx,The Dean Campustown,B3 XL,0,56,756.7857142857143,54,44,40,12,16,56,56,1,1,0,0
data-raw/data/original/pre_lease/Pre-Lease - 2024-06-05T144159.276.xlsx,The Dean Campustown,B4 XL,0,56,779.8148148148148,54,38,14,12,40,50,54,0.8928571428571429,0.9642857142857143,0.0714285714285714,2
data-raw/data/original/pre_lease/Pre-Lease - 2024-06-05T144159.276.xlsx,The Dean Campustown,D1,0,56,1049.642857142857,54,44,29,9,13,53,42,0.9464285714285714,0.75,-0.1964285714285714,14
data-raw/data/original/pre_lease/Pre-Lease - 2024-06-05T144159.276.xlsx,The Dean Campustown,D2,0,56,1034.2222222222222,55,32,38,16,7,48,45,0.8571428571428571,0.8035714285714286,-0.05357142857142849,11
data-raw/data/original/pre_lease/Pre-Lease - 2024-06-05T144159.276.xlsx,The Dean Campustown,D3,0,56,1104.025641025641,55,42,18,13,21,55,39,0.9821428571428571,0.6964285714285714,-0.2857142857142857,17
data-raw/data/original/pre_lease/Pre-Lease - 2024-06-05T144159.276.xlsx,The Dean Campustown,D4,0,56,1124.8148148148148,56,40,38,11,16,51,54,0.9107142857142857,0.9642857142857143,0.0535714285714286,2
data-raw/data/original/pre_lease/Pre-Lease - 2024-06-05T144159.276.xlsx,The Dean Campustown,D5,0,56,1148.867924528302,55,31,31,24,22,55,53,0.9821428571428571,0.9464285714285714,-0.0357142857142857,3
data-raw/data/original/pre_lease/Pre-Lease - 2024-06-05T144159.276.xlsx,The Dean Campustown,M1,0,84,1611.7261904761904,82,43,47,35,37,78,84,0.9285714285714286,1,0.0714285714285714,0
data-raw/data/original/pre_lease/Pre-Lease - 2024-06-05T144159.276.xlsx,The Dean Campustown,Not Selected,0,0,0,0,0,0,0,0,0,0,0,0,0,0
data-raw/data/original/pre_lease/Pre-Lease - 2024-06-05T144159.276.xlsx,The Dean Campustown,S1,0,42,1808.095238095238,41,19,21,20,21,39,42,0.9285714285714286,1,0.0714285714285714,0
data-raw/data/original/pre_lease/Pre-Lease - 2024-06-05T144159.276.xlsx,The Dean Campustown,S2,0,28,1823.9285714285713,27,13,16,11,12,24,28,0.8571428571428571,1,0.1428571428571429,0
data-raw/data/original/pre_lease/Pre-Lease - 2024-06-05T144159.276.xlsx,The Dean Campustown,S3 XL,0,28,1002.6785714285714,28,16,8,12,20,28,28,1,1,0,0
data-raw/data/original/pre_lease/Pre-Lease - 2024-08-13T115332.679.xlsx,1008 S. 4Th,B1,0,8,942.5,1,6,5,2,3,8,8,1,1,0,0
data-raw/data/original/pre_lease/Pre-Lease - 2024-08-13T115332.679.xlsx,1008 S. 4Th,B2,0,8,925,3,6,3,2,5,8,8,1,1,0,0
data-raw/data/original/pre_lease/Pre-Lease - 2024-08-13T115332.679.xlsx,1008 S. 4Th,B3,0,10,1059.5,4,9,6,1,4,10,10,1,1,0,0
data-raw/data/original/pre_lease/Pre-Lease - 2024-08-13T115332.679.xlsx,1008 S. 4Th,B4,0,2,1075,1,2,1,0,1,2,2,1,1,0,0
data-raw/data/original/pre_lease/Pre-Lease - 2024-08-13T115332.679.xlsx,1008 S. 4Th,B5,0,2,1110,0,2,2,0,0,2,2,1,1,0,0
data-raw/data/original/pre_lease/Pre-Lease - 2024-08-13T115332.679.xlsx,1008 S. 4Th,C1,0,12,879.1666666666666,3,10,9,2,3,12,12,1,1,0,0
data-raw/data/original/pre_lease/Pre-Lease - 2024-08-13T115332.679.xlsx,1008 S. 4Th,D1,0,16,811.25,9,16,7,0,9,16,16,1,1,0,0
data-raw/data/original/pre_lease/Pre-Lease - 2024-08-13T115332.679.xlsx,1008 S. 4Th,D1 Balcony,0,16,804.375,4,15,12,0,4,15,16,0.9375,1,0.0625,0
data-raw/data/original/pre_lease/Pre-Lease - 2024-08-13T115332.679.xlsx,1008 S. 4Th,D2,0,48,873.2291666666666,14,39,32,8,16,47,48,0.9791666666666666,1,0.02083333333333337,0
data-raw/data/original/pre_lease/Pre-Lease - 2024-08-13T115332.679.xlsx,1008 S. 4Th,D3 Balcony,0,12,944.1666666666666,2,12,10,0,2,12,12,1,1,0,0
data-raw/data/original/pre_lease/Pre-Lease - 2024-08-13T115332.679.xlsx,1008 S. 4Th,M1 Murphy,0,4,1085,1,3,3,1,1,4,4,1,1,0,0
data-raw/data/original/pre_lease/Pre-Lease - 2024-08-13T115332.679.xlsx,1008 S. 4Th,M1 Murphy Balcony,0,12,1180.8333333333333,2,9,10,2,2,11,12,0.9166666666666666,1,0.08333333333333337,0
data-raw/data/original/pre_lease/Pre-Lease - 2024-08-13T115332.679.xlsx,1008 S. 4Th,S1,0,4,1322.5,1,3,3,1,1,4,4,1,1,0,0
data-raw/data/original/pre_lease/Pre-Lease - 2024-08-13T115332.679.xlsx,1008 S. 4Th,S2,0,4,1267.5,2,2,2,2,2,4,4,1,1,0,0
data-raw/data/original/pre_lease/Pre-Lease - 2024-08-13T115332.679.xlsx,1047 Commonwealth Avenue,Not Selected,0,0,0,0,0,0,0,0,0,0,0,0,0,0
data-raw/data/original/pre_lease/Pre-Lease - 2024-08-13T115332.679.xlsx,1047 Commonwealth Avenue,S1,0,25,2783,12,12,13,13,12,25,25,1,1,0,0
data-raw/data/original/pre_lease/Pre-Lease - 2024-08-13T115332.679.xlsx,1047 Commonwealth Avenue,S2,0,12,2923.75,6,8,6,4,6,12,12,1,1,0,0
data-raw/data/original/pre_lease/Pre-Lease - 2024-08-13T115332.679.xlsx,1047 Commonwealth Avenue,S3,0,51,3013.235294117647,15,31,19,20,15,51,34,1,0.6666666666666666,-0.33333333333333337,17
data-raw/data/original/pre_lease/Pre-Lease - 2024-08-13T115332.679.xlsx,1047 Commonwealth Avenue,S4,0,8,2946.875,5,6,4,2,4,8,8,1,1,0,0
data-raw/data/original/pre_lease/Pre-Lease - 2024-08-13T115332.679.xlsx,1047 Commonwealth Avenue,S5,0,10,3081,4,5,6,4,4,9,10,0.9,1,0.09999999999999998,0
data-raw/data/original/pre_lease/Pre-Lease - 2024-08-13T115332.679.xlsx,1047 Commonwealth Avenue,S6,0,29,3282.7586206896553,10,17,19,11,10,28,29,0.9655172413793104,1,0.03448275862068961,0
data-raw/data/original/pre_lease/Pre-Lease - 2024-08-13T115332.679.xlsx,1047 Commonwealth Avenue,S7,0,4,3337.5,2,3,2,1,2,4,4,1,1,0,0
data-raw/data/original/pre_lease/Pre-Lease - 2024-08-13T115332.679.xlsx,1047 Commonwealth Avenue,S8,0,11,3381.6666666666665,2,5,1,6,2,11,3,1,0.2727272727272727,-0.7272727272727273,8
data-raw/data/original/pre_lease/Pre-Lease - 2024-08-13T115332.679.xlsx,1047 Commonwealth Avenue,S9,0,5,3950,0,3,4,2,0,5,4,1,0.8,-0.19999999999999996,1
data-raw/data/original/pre_lease/Pre-Lease - 2024-08-13T115332.679.xlsx,1047 Commonwealth Avenue,S10,0,4,4047.5,2,3,0,1,2,4,2,1,0.5,-0.5,2
data-raw/data/original/pre_lease/Pre-Lease - 2024-08-13T115332.679.xlsx,1047 Commonwealth Avenue,S11,0,24,1168.142857142857,20,6,6,16,15,22,21,0.9166666666666666,0.875,-0.04166666666666663,3
data-raw/data/original/pre_lease/Pre-Lease - 2024-08-13T115332.679.xlsx,307 E. Daniel,D1,0,40,960.25,16,34,24,5,16,39,40,0.975,1,0.025000000000000022,0
data-raw/data/original/pre_lease/Pre-Lease - 2024-08-13T115332.679.xlsx,501 S. 6Th,B1,0,2,895,2,2,0,0,2,2,2,1,1,0,0
data-raw/data/original/pre_lease/Pre-Lease - 2024-08-13T115332.679.xlsx,501 S. 6Th,B2,0,2,915,2,2,0,0,2,2,2,1,1,0,0
data-raw/data/original/pre_lease/Pre-Lease - 2024-08-13T115332.679.xlsx,501 S. 6Th,C1,0,12,935,0,9,14,3,0,12,14,1,1.1666666666666667,0.16666666666666674,-2
data-raw/data/original/pre_lease/Pre-Lease - 2024-08-13T115332.679.xlsx,501 S. 6Th,C2,0,12,960.4166666666666,3,12,9,0,3,12,12,1,1,0,0
data-raw/data/original/pre_lease/Pre-Lease - 2024-08-13T115332.679.xlsx,501 S. 6Th,D1,0,16,706.875,13,16,3,0,13,16,16,1,1,0,0
data-raw/data/original/pre_lease/Pre-Lease - 2024-08-13T115332.679.xlsx,501 S. 6Th,D2,0,16,720,8,5,8,11,8,16,16,1,1,0,0
data-raw/data/original/pre_lease/Pre-Lease - 2024-08-13T115332.679.xlsx,501 S. 6Th,D3 Townhome,0,4,825,0,1,4,2,0,3,4,0.75,1,0.25,0
data-raw/data/original/pre_lease/Pre-Lease - 2024-08-13T115332.679.xlsx,501 S. 6Th,E1 Townhome,0,20,791.5,12,17,8,3,12,20,20,1,1,0,0
data-raw/data/original/pre_lease/Pre-Lease - 2024-08-13T115332.679.xlsx,501 S. 6Th,E2 Townhome,0,20,815,14,11,6,8,14,19,20,0.95,1,0.050000000000000044,0
data-raw/data/original/pre_lease/Pre-Lease - 2024-08-13T115332.679.xlsx,501 S. 6Th,Not Selected,0,0,920,0,0,1,0,0,0,1,0,0,0,0
data-raw/data/original/pre_lease/Pre-Lease - 2024-08-13T115332.679.xlsx,908 S. 1St,A1,0,16,1380,4,11,12,4,4,15,16,0.9375,1,0.0625,0
data-raw/data/original/pre_lease/Pre-Lease - 2024-08-13T115332.679.xlsx,908 S. 1St,B1,0,8,874.375,2,8,6,0,2,8,8,1,1,0,0
data-raw/data/original/pre_lease/Pre-Lease - 2024-08-13T115332.679.xlsx,908 S. 1St,B2,0,16,892.1875,6,14,10,2,6,16,16,1,1,0,0
data-raw/data/original/pre_lease/Pre-Lease - 2024-08-13T115332.679.xlsx,908 S. 1St,B3,0,8,970,2,8,6,0,2,8,8,1,1,0,0
data-raw/data/original/pre_lease/Pre-Lease - 2024-08-13T115332.679.xlsx,908 S. 1St,D1,0,16,853.75,10,13,6,0,10,13,16,0.8125,1,0.1875,0
data-raw/data/original/pre_lease/Pre-Lease - 2024-08-13T115332.679.xlsx,908 S. 1St,M1 Murphy,0,12,1071.6666666666667,4,10,7,2,5,12,12,1,1,0,0
data-raw/data/original/pre_lease/Pre-Lease - 2024-08-13T115332.679.xlsx,908 S. 1St,M1 Murphy Balcony,0,16,1117.8125,5,10,11,6,5,16,16,1,1,0,0
data-raw/data/original/pre_lease/Pre-Lease - 2024-08-13T115332.679.xlsx,908 S. 1St,M2 Murphy,0,4,1125,0,3,4,2,0,5,4,1.25,1,-0.25,0
data-raw/data/original/pre_lease/Pre-Lease - 2024-08-13T115332.679.xlsx,Academy 65,A1,0,10,1857.244,5,2,4,7,6,9,10,0.9,1,0.09999999999999998,0
data-raw/data/original/pre_lease/Pre-Lease - 2024-08-13T115332.679.xlsx,Academy 65,B1,0,21,1023.4171428571428,8,18,13,4,8,22,21,1.0476190476190477,1,-0.04761904761904767,0
data-raw/data/original/pre_lease/Pre-Lease - 2024-08-13T115332.679.xlsx,Academy 65,B1 Semi-Shared,0,21,897.3157894736842,5,11,14,10,5,21,19,1,0.9047619047619048,-0.09523809523809523,2
data-raw/data/original/pre_lease/Pre-Lease - 2024-08-13T115332.679.xlsx,Academy 65,C1 Study,0,3,1071.6666666666667,0,1,3,1,0,2,3,0.6666666666666666,1,0.33333333333333337,0
data-raw/data/original/pre_lease/Pre-Lease - 2024-08-13T115332.679.xlsx,Academy 65,D1 Balcony,0,40,975.8347826086957,6,18,17,11,6,29,23,0.725,0.575,-0.15000000000000002,17
data-raw/data/original/pre_lease/Pre-Lease - 2024-08-13T115332.679.xlsx,Academy 65,D2,0,64,967.7585714285715,26,20,28,34,28,54,56,0.84375,0.875,0.03125,8
data-raw/data/original/pre_lease/Pre-Lease - 2024-08-13T115332.679.xlsx,Academy 65,D3,0,20,820.75,11,11,9,10,11,21,20,1.05,1,-0.050000000000000044,0
data-raw/data/original/pre_lease/Pre-Lease - 2024-08-13T115332.679.xlsx,Academy 65,D3 Semi-Shared,0,120,840.4686363636364,55,34,31,62,57,96,88,0.8,0.7333333333333333,-0.06666666666666676,32
data-raw/data/original/pre_lease/Pre-Lease - 2024-08-13T115332.679.xlsx,Academy 65,Not Selected,0,0,0,0,0,0,0,0,0,0,0,0,0,0
data-raw/data/original/pre_lease/Pre-Lease - 2024-08-13T115332.679.xlsx,Academy 65,S1,0,5,1582.8,2,3,2,1,3,4,5,0.8,1,0.19999999999999996,0
data-raw/data/original/pre_lease/Pre-Lease - 2024-08-13T115332.679.xlsx,Academy 65,S2,0,5,1561,2,4,2,1,3,5,5,1,1,0,0
data-raw/data/original/pre_lease/Pre-Lease - 2024-08-13T115332.679.xlsx,Academy Lincoln,B1,0,30,868.5,12,23,16,5,14,28,30,0.9333333333333333,1,0.06666666666666665,0
data-raw/data/original/pre_lease/Pre-Lease - 2024-08-13T115332.679.xlsx,Academy Lincoln,B2,0,38,888.2894736842105,16,22,22,16,16,38,38,1,1,0,0
data-raw/data/original/pre_lease/Pre-Lease - 2024-08-13T115332.679.xlsx,Academy Lincoln,B3 Townhome,0,14,941.8571428571429,9,10,5,4,9,14,14,1,1,0,0
data-raw/data/original/pre_lease/Pre-Lease - 2024-08-13T115332.679.xlsx,Academy Lincoln,C1,0,42,825.75,7,25,33,15,7,40,40,0.9523809523809523,0.9523809523809523,0,2
data-raw/data/original/pre_lease/Pre-Lease - 2024-08-13T115332.679.xlsx,Academy Lincoln,D1,0,472,693.272921108742,174,329,289,122,180,451,469,0.9555084745762712,0.9936440677966102,0.03813559322033899,3
data-raw/data/original/pre_lease/Pre-Lease - 2024-08-13T115332.679.xlsx,Academy Lincoln,D2,0,36,744.1666666666666,12,21,23,9,13,30,36,0.8333333333333334,1,0.16666666666666663,0
data-raw/data/original/pre_lease/Pre-Lease - 2024-08-13T115332.679.xlsx,Academy Lincoln,Not Selected,0,0,0,0,0,0,0,0,0,0,0,0,0,0
data-raw/data/original/pre_lease/Pre-Lease - 2024-08-13T115332.679.xlsx,Anova Ucity Square,A1,0,6,2122.8333333333335,6,5,4,2,2,7,6,1.1666666666666667,1,-0.16666666666666674,0
data-raw/data/original/pre_lease/Pre-Lease - 2024-08-13T115332.679.xlsx,Anova Ucity Square,A2,0,17,2168.5,14,7,12,7,4,14,16,0.8235294117647058,0.9411764705882353,0.11764705882352944,1
data-raw/data/original/pre_lease/Pre-Lease - 2024-08-13T115332.679.xlsx,Anova Ucity Square,A3,0,10,2085.8888888888887,10,7,7,2,2,9,9,0.9,0.9,0,1
data-raw/data/original/pre_lease/Pre-Lease - 2024-08-13T115332.679.xlsx,Anova Ucity Square,A4,0,20,2069.1111111111113,15,9,11,10,7,19,18,0.95,0.9,-0.04999999999999993,2
data-raw/data/original/pre_lease/Pre-Lease - 2024-08-13T115332.679.xlsx,Anova Ucity Square,A5,0,6,2249,4,3,3,2,2,5,5,0.8333333333333334,0.8333333333333334,0,1
data-raw/data/original/pre_lease/Pre-Lease - 2024-08-13T115332.679.xlsx,Anova Ucity Square,A6,0,5,2290.8,5,2,5,3,0,5,5,1,1,0,0
data-raw/data/original/pre_lease/Pre-Lease - 2024-08-13T115332.679.xlsx,Anova Ucity Square,A7,0,5,2093.8,5,3,3,2,2,5,5,1,1,0,0
data-raw/data/original/pre_lease/Pre-Lease - 2024-08-13T115332.679.xlsx,Anova Ucity Square,A8,0,186,2418.3333333333335,162,69,103,93,68,162,171,0.8709677419354839,0.9193548387096774,0.048387096774193505,15
data-raw/data/original/pre_lease/Pre-Lease - 2024-08-13T115332.679.xlsx,Anova Ucity Square,B1,0,11,3420.7272727272725,8,6,10,4,1,10,11,0.9090909090909091,1,0.09090909090909094,0
data-raw/data/original/pre_lease/Pre-Lease - 2024-08-13T115332.679.xlsx,Anova Ucity Square,B2,0,22,3588.3636363636365,21,17,13,4,9,21,22,0.9545454545454546,1,0.045454545454545414,0
data-raw/data/original/pre_lease/Pre-Lease - 2024-08-13T115332.679.xlsx,Anova Ucity Square,C1,0,5,4123.6,5,3,4,0,1,3,5,0.6,1,0.4,0
data-raw/data/original/pre_lease/Pre-Lease - 2024-08-13T115332.679.xlsx,Anova Ucity Square,Not Selected,0,0,0,0,0,0,0,0,0,0,0,0,0,0
data-raw/data/original/pre_lease/Pre-Lease - 2024-08-13T115332.679.xlsx,Anova Ucity Square,S1,0,168,1840.7088607594937,141,85,111,65,47,150,158,0.8928571428571429,0.9404761904761905,0.04761904761904756,10
data-raw/data/original/pre_lease/Pre-Lease - 2024-08-13T115332.679.xlsx,Courts At Spring Mill Station,1 Bed 1 Bath,0,147,2039.1948905109489,141,50,50,83,87,133,137,0.9047619047619048,0.9319727891156463,0.027210884353741527,10
data-raw/data/original/pre_lease/Pre-Lease - 2024-08-13T115332.679.xlsx,Courts At Spring Mill Station,1 Bed 1 Bath ADA,0,4,2061,1,1,1,3,0,4,1,1,0.25,-0.75,3
data-raw/data/original/pre_lease/Pre-Lease - 2024-08-13T115332.679.xlsx,Courts At Spring Mill Station,1 Bed 1 Bath Loft,0,12,2413.804166666667,12,4,5,5,7,9,12,0.75,1,0.25,0
data-raw/data/original/pre_lease/Pre-Lease - 2024-08-13T115332.679.xlsx,Courts At Spring Mill Station,1 Bed 1 Bath w/ Den,0,31,2345.3214285714284,30,13,8,17,20,30,28,0.967741935483871,0.9032258064516129,-0.06451612903225812,3
data-raw/data/original/pre_lease/Pre-Lease - 2024-08-13T115332.679.xlsx,Courts At Spring Mill Station,1Bed1.5 Bath w/ Den,0,3,2367,3,2,1,1,2,3,3,1,1,0,0
data-raw/data/original/pre_lease/Pre-Lease - 2024-08-13T115332.679.xlsx,Courts At Spring Mill Station,1Bed1Bath Loftw/ Den,0,3,2819.65,3,1,3,1,0,2,3,0.6666666666666666,1,0.33333333333333337,0
data-raw/data/original/pre_lease/Pre-Lease - 2024-08-13T115332.679.xlsx,Courts At Spring Mill Station,2 Bed 2 Bath,0,147,2581.626277372263,140,44,49,98,88,142,137,0.9659863945578231,0.9319727891156463,-0.0340136054421768,10
data-raw/data/original/pre_lease/Pre-Lease - 2024-08-13T115332.679.xlsx,Courts At Spring Mill Station,2 Bed 2 Bath ADA,0,4,2439.3333333333335,3,0,2,2,1,2,3,0.5,0.75,0.25,1
data-raw/data/original/pre_lease/Pre-Lease - 2024-08-13T115332.679.xlsx,Courts At Spring Mill Station,2 Bed 2 Bath Loft,0,9,3089.8571428571427,7,5,3,3,4,8,7,0.8888888888888888,0.7777777777777778,-0.11111111111111105,2
data-raw/data/original/pre_lease/Pre-Lease - 2024-08-13T115332.679.xlsx,Courts At Spring Mill Station,2 Bed 2 Bath w/ Den,0,23,3157.842105263158,20,8,8,13,11,21,19,0.9130434782608695,0.8260869565217391,-0.08695652173913038,4
data-raw/data/original/pre_lease/Pre-Lease - 2024-08-13T115332.679.xlsx,Courts At Spring Mill Station,2Bed2Bath Loftw/ Den,0,1,3565,1,0,0,1,1,1,1,1,1,0,0
data-raw/data/original/pre_lease/Pre-Lease - 2024-08-13T115332.679.xlsx,Courts At Spring Mill Station,COMMERCIAL,0,1,0,0,0,0,0,0,0,0,0,0,0,1
data-raw/data/original/pre_lease/Pre-Lease - 2024-08-13T115332.679.xlsx,Courts At Spring Mill Station,Not Selected,0,0,0,0,0,0,0,0,0,0,0,0,0,0
data-raw/data/original/pre_lease/Pre-Lease - 2024-08-13T115332.679.xlsx,Courts At Spring Mill Station,Studio,0,1,0,1,0,0,0,0,0,0,0,0,0,1
data-raw/data/original/pre_lease/Pre-Lease - 2024-08-13T115332.679.xlsx,Shortbread Lofts,B1,0,40,1163.5,31,32,32,8,8,40,40,1,1,0,0
data-raw/data/original/pre_lease/Pre-Lease - 2024-08-13T115332.679.xlsx,Shortbread Lofts,B2,0,10,1588,6,8,9,2,1,10,10,1,1,0,0
data-raw/data/original/pre_lease/Pre-Lease - 2024-08-13T115332.679.xlsx,Shortbread Lofts,B3,0,2,1532.5,2,2,0,0,2,2,2,1,1,0,0
data-raw/data/original/pre_lease/Pre-Lease - 2024-08-13T115332.679.xlsx,Shortbread Lofts,B4,0,2,1542.5,1,2,1,0,1,2,2,1,1,0,0
data-raw/data/original/pre_lease/Pre-Lease - 2024-08-13T115332.679.xlsx,Shortbread Lofts,C1,0,56,1335.7142857142858,44,49,50,7,6,56,56,1,1,0,0
data-raw/data/original/pre_lease/Pre-Lease - 2024-08-13T115332.679.xlsx,Shortbread Lofts,C2,0,6,1020,2,6,6,0,0,6,6,1,1,0,0
data-raw/data/original/pre_lease/Pre-Lease - 2024-08-13T115332.679.xlsx,Shortbread Lofts,C3,0,20,1296.75,16,20,20,0,0,20,20,1,1,0,0
data-raw/data/original/pre_lease/Pre-Lease - 2024-08-13T115332.679.xlsx,Shortbread Lofts,C4,0,24,1181.4583333333333,16,22,22,2,2,24,24,1,1,0,0
data-raw/data/original/pre_lease/Pre-Lease - 2024-08-13T115332.679.xlsx,Shortbread Lofts,D1,0,205,1183.0243902439024,166,202,200,2,5,204,205,0.9951219512195122,1,0.004878048780487809,0
data-raw/data/original/pre_lease/Pre-Lease - 2024-08-13T115332.679.xlsx,Shortbread Lofts,D2,0,9,1363.3333333333333,7,9,7,0,2,9,9,1,1,0,0
data-raw/data/original/pre_lease/Pre-Lease - 2024-08-13T115332.679.xlsx,Shortbread Lofts,Not Selected,0,0,0,0,0,0,0,0,0,0,0,0,0,0
data-raw/data/original/pre_lease/Pre-Lease - 2024-08-13T115332.679.xlsx,Sova,A1,0,20,1418.095238095238,17,0,8,20,13,20,21,1,1.05,0.050000000000000044,-1
data-raw/data/original/pre_lease/Pre-Lease - 2024-08-13T115332.679.xlsx,Sova,B1,0,64,1102.2142857142858,55,22,43,39,27,61,70,0.953125,1.09375,0.140625,-6
data-raw/data/original/pre_lease/Pre-Lease - 2024-08-13T115332.679.xlsx,Sova,B1 ALT,0,30,1193.0645161290322,27,13,13,16,18,29,31,0.9666666666666667,1.0333333333333334,0.06666666666666676,-1
data-raw/data/original/pre_lease/Pre-Lease - 2024-08-13T115332.679.xlsx,Sova,C1,0,66,979.5652173913044,60,40,36,26,33,66,69,1,1.0454545454545454,0.045454545454545414,-3
data-raw/data/original/pre_lease/Pre-Lease - 2024-08-13T115332.679.xlsx,Sova,D1,0,308,960.4388714733542,283,171,189,133,130,304,319,0.987012987012987,1.0357142857142858,0.0487012987012988,-11
data-raw/data/original/pre_lease/Pre-Lease - 2024-08-13T115332.679.xlsx,Sova,D2,0,88,968.2022471910112,83,48,51,40,38,88,89,1,1.0113636363636365,0.011363636363636465,-1
data-raw/data/original/pre_lease/Pre-Lease - 2024-08-13T115332.679.xlsx,Sova,D3,0,240,985.0607287449393,230,128,130,113,117,241,247,1.0041666666666667,1.0291666666666666,0.02499999999999991,-7
data-raw/data/original/pre_lease/Pre-Lease - 2024-08-13T115332.679.xlsx,Sova,Not Selected,0,0,0,0,0,0,0,0,0,0,0,0,0,0
data-raw/data/original/pre_lease/Pre-Lease - 2024-08-13T115332.679.xlsx,Station Nine,a1a 1F Courtyard Stack,0,12,1700.2727272727273,10,6,8,2,3,8,11,0.6666666666666666,0.9166666666666666,0.25,1
data-raw/data/original/pre_lease/Pre-Lease - 2024-08-13T115332.679.xlsx,Station Nine,a1a 1F Pool Stack,0,4,1744.6666666666667,2,2,3,2,0,4,3,1,0.75,-0.25,1
data-raw/data/original/pre_lease/Pre-Lease - 2024-08-13T115332.679.xlsx,Station Nine,a1a 1F Stack,0,12,1494.2,9,7,9,4,1,11,10,0.9166666666666666,0.8333333333333334,-0.08333333333333326,2
data-raw/data/original/pre_lease/Pre-Lease - 2024-08-13T115332.679.xlsx,Station Nine,a1a Courtyard Stack,0,24,1773.625,23,20,19,4,5,24,24,1,1,0,0
data-raw/data/original/pre_lease/Pre-Lease - 2024-08-13T115332.679.xlsx,Station Nine,a1a Pool Stack,0,10,1821.1,10,9,7,1,3,10,10,1,1,0,0
data-raw/data/original/pre_lease/Pre-Lease - 2024-08-13T115332.679.xlsx,Station Nine,a1a stack,0,23,1698.8181818181818,22,17,12,5,10,22,22,0.9565217391304348,0.9565217391304348,0,1
data-raw/data/original/pre_lease/Pre-Lease - 2024-08-13T115332.679.xlsx,Station Nine,a1a TF Pool Stack,0,1,1690,1,1,0,0,1,1,1,1,1,0,0
data-raw/data/original/pre_lease/Pre-Lease - 2024-08-13T115332.679.xlsx,Station Nine,a1a TF Stack,0,4,1850.5,4,3,2,0,2,3,4,0.75,1,0.25,0
data-raw/data/original/pre_lease/Pre-Lease - 2024-08-13T115332.679.xlsx,Station Nine,a1al TF Courtyard Stack,0,12,2087.5,9,9,5,1,3,10,8,0.8333333333333334,0.6666666666666666,-0.16666666666666674,4
data-raw/data/original/pre_lease/Pre-Lease - 2024-08-13T115332.679.xlsx,Station Nine,a1al TF Pool Stack,0,4,2085.75,4,2,3,2,1,4,4,1,1,0,0
data-raw/data/original/pre_lease/Pre-Lease - 2024-08-13T115332.679.xlsx,Station Nine,a1al TF Stack,0,8,2012.2,6,4,3,3,2,7,5,0.875,0.625,-0.25,3
data-raw/data/original/pre_lease/Pre-Lease - 2024-08-13T115332.679.xlsx,Station Nine,a1b Pool Stack,0,2,1818.5,2,1,1,1,1,2,2,1,1,0,0
data-raw/data/original/pre_lease/Pre-Lease - 2024-08-13T115332.679.xlsx,Station Nine,a1b Stack,0,1,1860,1,1,0,0,1,1,1,1,1,0,0
data-raw/data/original/pre_lease/Pre-Lease - 2024-08-13T115332.679.xlsx,Station Nine,a1bl TF Pool Stack,0,1,2100,1,1,1,0,0,1,1,1,1,0,0
data-raw/data/original/pre_lease/Pre-Lease - 2024-08-13T115332.679.xlsx,Station Nine,a1bl TF Stack,0,1,2190,1,1,1,0,0,1,1,1,1,0,0
data-raw/data/original/pre_lease/Pre-Lease - 2024-08-13T115332.679.xlsx,Station Nine,a1c 1F Stack,0,1,1595,1,1,1,0,0,1,1,1,1,0,0
data-raw/data/original/pre_lease/Pre-Lease - 2024-08-13T115332.679.xlsx,Station Nine,a1hc 1F Pool Side by Side,0,1,1620,1,0,1,1,0,1,1,1,1,0,0
data-raw/data/original/pre_lease/Pre-Lease - 2024-08-13T115332.679.xlsx,Station Nine,a1hc 1F Side by Side,0,1,1791,1,1,1,0,0,1,1,1,1,0,0
data-raw/data/original/pre_lease/Pre-Lease - 2024-08-13T115332.679.xlsx,Station Nine,a1hc 1F Stack,0,1,1750,1,0,1,1,0,1,1,1,1,0,0
data-raw/data/original/pre_lease/Pre-Lease - 2024-08-13T115332.679.xlsx,Station Nine,a1hc Pool Side by Side,0,2,1755.5,2,2,1,0,1,2,2,1,1,0,0
data-raw/data/original/pre_lease/Pre-Lease - 2024-08-13T115332.679.xlsx,Station Nine,a1hc Side by Side,0,3,1782.5,3,1,2,0,0,1,2,0.3333333333333333,0.6666666666666666,0.3333333333333333,1
data-raw/data/original/pre_lease/Pre-Lease - 2024-08-13T115332.679.xlsx,Station Nine,a1hc TF Pool Side by Side,0,1,1840,1,0,1,1,0,1,1,1,1,0,0
data-raw/data/original/pre_lease/Pre-Lease - 2024-08-13T115332.679.xlsx,Station Nine,a1hc TF Side by Side,0,2,1845,2,1,1,0,1,1,2,0.5,1,0.5,0
data-raw/data/original/pre_lease/Pre-Lease - 2024-08-13T115332.679.xlsx,Station Nine,a2 1F Pool Side by Side,0,1,0,0,0,0,1,0,1,0,1,0,-1,1
data-raw/data/original/pre_lease/Pre-Lease - 2024-08-13T115332.679.xlsx,Station Nine,a2 Pool Side by Side,0,2,1732.5,1,0,2,2,0,2,2,1,1,0,0
data-raw/data/original/pre_lease/Pre-Lease - 2024-08-13T115332.679.xlsx,Station Nine,a2 TF Pool Side by Side,0,1,1885,1,0,0,1,1,1,1,1,1,0,0
data-raw/data/original/pre_lease/Pre-Lease - 2024-08-13T115332.679.xlsx,Station Nine,a3a 1F Pool Side by Side,0,4,1855,1,1,1,0,0,1,1,0.25,0.25,0,3
data-raw/data/original/pre_lease/Pre-Lease - 2024-08-13T115332.679.xlsx,Station Nine,a3a 1F Side by Side,0,2,1680,1,0,1,1,0,1,1,0.5,0.5,0,1
data-raw/data/original/pre_lease/Pre-Lease - 2024-08-13T115332.679.xlsx,Station Nine,a3a Pool Side by Side,0,8,2053.875,8,5,5,0,3,5,8,0.625,1,0.375,0
data-raw/data/original/pre_lease/Pre-Lease - 2024-08-13T115332.679.xlsx,Station Nine,a3a Side by Side,0,4,1912.3333333333333,3,2,3,1,0,3,3,0.75,0.75,0,1
data-raw/data/original/pre_lease/Pre-Lease - 2024-08-13T115332.679.xlsx,Station Nine,a3a TF Pool Side by Side,0,2,1952.5,1,2,1,0,1,2,2,1,1,0,0
data-raw/data/original/pre_lease/Pre-Lease - 2024-08-13T115332.679.xlsx,Station Nine,a3a TF Side by Side,0,2,1949,2,1,1,1,1,2,2,1,1,0,0
data-raw/data/original/pre_lease/Pre-Lease - 2024-08-13T115332.679.xlsx,Station Nine,a3al TF Pool Side by Side,0,1,2180,1,0,1,1,0,1,1,1,1,0,0
data-raw/data/original/pre_lease/Pre-Lease - 2024-08-13T115332.679.xlsx,Station Nine,a3al TF Pool Stack,0,1,2270,1,1,0,0,1,1,1,1,1,0,0
data-raw/data/original/pre_lease/Pre-Lease - 2024-08-13T115332.679.xlsx,Station Nine,a3b 1F Side by Side,0,2,1935,1,1,1,0,0,1,1,0.5,0.5,0,1
data-raw/data/original/pre_lease/Pre-Lease - 2024-08-13T115332.679.xlsx,Station Nine,a3b Side by Side,0,6,1919.1666666666667,4,2,6,1,0,3,6,0.5,1,0.5,0
data-raw/data/original/pre_lease/Pre-Lease - 2024-08-13T115332.679.xlsx,Station Nine,a3b TF Side by Side,0,2,1932.5,1,0,2,0,0,0,2,0,1,1,0
data-raw/data/original/pre_lease/Pre-Lease - 2024-08-13T115332.679.xlsx,Station Nine,a3bl TF Side by Side,0,2,2135,2,1,2,1,0,2,2,1,1,0,0
data-raw/data/original/pre_lease/Pre-Lease - 2024-08-13T115332.679.xlsx,Station Nine,a3c Side by Side,0,1,1938,1,0,1,0,0,0,1,0,1,1,0
data-raw/data/original/pre_lease/Pre-Lease - 2024-08-13T115332.679.xlsx,Station Nine,a3c TF Side by Side,0,1,1950,1,0,1,1,0,1,1,1,1,0,0
data-raw/data/original/pre_lease/Pre-Lease - 2024-08-13T115332.679.xlsx,Station Nine,a3d Side by Side,0,2,1960,2,0,2,1,0,1,2,0.5,1,0.5,0
data-raw/data/original/pre_lease/Pre-Lease - 2024-08-13T115332.679.xlsx,Station Nine,a3dl TF Side by Side,0,1,2293,1,1,1,0,0,1,1,1,1,0,0
data-raw/data/original/pre_lease/Pre-Lease - 2024-08-13T115332.679.xlsx,Station Nine,a4 1F Side by Side,0,1,0,0,0,0,0,0,0,0,0,0,0,1
data-raw/data/original/pre_lease/Pre-Lease - 2024-08-13T115332.679.xlsx,Station Nine,a4 1F Stack,0,1,0,0,0,0,0,0,0,0,0,0,0,1
data-raw/data/original/pre_lease/Pre-Lease - 2024-08-13T115332.679.xlsx,Station Nine,a4 Stack,0,4,1782.5,2,3,1,1,1,4,2,1,0.5,-0.5,2
data-raw/data/original/pre_lease/Pre-Lease - 2024-08-13T115332.679.xlsx,Station Nine,a4 TF Stack,0,2,1805,2,0,2,0,0,0,2,0,1,1,0
data-raw/data/original/pre_lease/Pre-Lease - 2024-08-13T115332.679.xlsx,Station Nine,a5 1F Pool Side by Side Terrace,0,1,1582,1,0,1,0,0,0,1,0,1,1,0
data-raw/data/original/pre_lease/Pre-Lease - 2024-08-13T115332.679.xlsx,Station Nine,a5 Pool Side by Side Terrace,0,2,2027,2,1,2,0,0,1,2,0.5,1,0.5,0
data-raw/data/original/pre_lease/Pre-Lease - 2024-08-13T115332.679.xlsx,Station Nine,a5 TF Pool Side by Side Terrace,0,1,0,0,0,0,1,0,1,0,1,0,-1,1
data-raw/data/original/pre_lease/Pre-Lease - 2024-08-13T115332.679.xlsx,Station Nine,a6 Stack,0,1,2038,0,1,1,0,0,1,1,1,1,0,0
data-raw/data/original/pre_lease/Pre-Lease - 2024-08-13T115332.679.xlsx,Station Nine,b1 1F Courtyard Side by Side,0,4,2333.5,3,3,2,0,2,3,4,0.75,1,0.25,0
data-raw/data/original/pre_lease/Pre-Lease - 2024-08-13T115332.679.xlsx,Station Nine,b1 1F Pool Side by Side,0,2,2337,2,1,0,1,2,2,2,1,1,0,0
data-raw/data/original/pre_lease/Pre-Lease - 2024-08-13T115332.679.xlsx,Station Nine,b1 1F Side by Side,0,9,2262.125,6,6,6,2,2,8,8,0.8888888888888888,0.8888888888888888,0,1
data-raw/data/original/pre_lease/Pre-Lease - 2024-08-13T115332.679.xlsx,Station Nine,b1 Courtyard Side by Side,0,8,2383.125,5,6,7,2,1,8,8,1,1,0,0
data-raw/data/original/pre_lease/Pre-Lease - 2024-08-13T115332.679.xlsx,Station Nine,b1 Pool Side by Side,0,4,2360.5,2,2,3,2,1,4,4,1,1,0,0
data-raw/data/original/pre_lease/Pre-Lease - 2024-08-13T115332.679.xlsx,Station Nine,b1 Side by Side,0,19,2306.8333333333335,16,12,14,7,4,19,18,1,0.9473684210526315,-0.052631578947368474,1
data-raw/data/original/pre_lease/Pre-Lease - 2024-08-13T115332.679.xlsx,Station Nine,b1 TF Side by Side,0,3,2424.3333333333335,3,3,3,0,0,3,3,1,1,0,0
data-raw/data/original/pre_lease/Pre-Lease - 2024-08-13T115332.679.xlsx,Station Nine,b1al TF Courtyard Side by Side,0,4,2785.5,3,2,3,1,1,3,4,0.75,1,0.25,0
data-raw/data/original/pre_lease/Pre-Lease - 2024-08-13T115332.679.xlsx,Station Nine,b1al TF Pool Side by Side,0,1,0,0,0,0,1,0,1,0,1,0,-1,1
data-raw/data/original/pre_lease/Pre-Lease - 2024-08-13T115332.679.xlsx,Station Nine,b1al TF Side by Side,0,6,2708.75,4,0,2,2,2,2,4,0.3333333333333333,0.6666666666666666,0.3333333333333333,2
data-raw/data/original/pre_lease/Pre-Lease - 2024-08-13T115332.679.xlsx,Station Nine,b1bl TF Pool Side by Side,0,1,2740,1,1,1,0,0,1,1,1,1,0,0
data-raw/data/original/pre_lease/Pre-Lease - 2024-08-13T115332.679.xlsx,Station Nine,b1bl TF Side by Side,0,4,2705,3,2,2,1,1,3,3,0.75,0.75,0,1
data-raw/data/original/pre_lease/Pre-Lease - 2024-08-13T115332.679.xlsx,Station Nine,b1hc 1F Side by Side,0,1,2200,1,0,1,1,0,1,1,1,1,0,0
data-raw/data/original/pre_lease/Pre-Lease - 2024-08-13T115332.679.xlsx,Station Nine,b1hc Side by Side,0,3,2388,3,2,3,1,0,3,3,1,1,0,0
data-raw/data/original/pre_lease/Pre-Lease - 2024-08-13T115332.679.xlsx,Station Nine,b2a 1F Courtyard Side by Side,0,2,2384.5,2,0,0,2,2,2,2,1,1,0,0
data-raw/data/original/pre_lease/Pre-Lease - 2024-08-13T115332.679.xlsx,Station Nine,b2a 1F Side by Side,0,2,2491,0,1,1,0,0,1,1,0.5,0.5,0,1
data-raw/data/original/pre_lease/Pre-Lease - 2024-08-13T115332.679.xlsx,Station Nine,b2a Courtyard Side by Side,0,4,2513.25,4,3,2,1,2,4,4,1,1,0,0
data-raw/data/original/pre_lease/Pre-Lease - 2024-08-13T115332.679.xlsx,Station Nine,b2a Side by Side,0,4,2396.25,3,2,4,2,0,4,4,1,1,0,0
data-raw/data/original/pre_lease/Pre-Lease - 2024-08-13T115332.679.xlsx,Station Nine,b2al TF Courtyard Side by Side,0,2,2975,1,1,0,1,1,2,1,1,0.5,-0.5,1
data-raw/data/original/pre_lease/Pre-Lease - 2024-08-13T115332.679.xlsx,Station Nine,b2al TF Side by Side,0,1,0,0,0,0,0,0,0,0,0,0,0,1
data-raw/data/original/pre_lease/Pre-Lease - 2024-08-13T115332.679.xlsx,Station Nine,b2b 1F Courtyard Side by Side,0,2,2305,0,1,2,1,0,2,2,1,1,0,0
data-raw/data/original/pre_lease/Pre-Lease - 2024-08-13T115332.679.xlsx,Station Nine,b2b 1F Side by Side,0,1,2390,1,1,1,0,0,1,1,1,1,0,0
data-raw/data/original/pre_lease/Pre-Lease - 2024-08-13T115332.679.xlsx,Station Nine,b2b Courtyard Side by Side,0,4,2488.25,4,4,4,0,0,4,4,1,1,0,0
data-raw/data/original/pre_lease/Pre-Lease - 2024-08-13T115332.679.xlsx,Station Nine,b2b Side by Side,0,2,2517,2,1,2,1,0,2,2,1,1,0,0
data-raw/data/original/pre_lease/Pre-Lease - 2024-08-13T115332.679.xlsx,Station Nine,b2bl TF Courtyard Side by Side,0,2,2982,1,0,0,0,1,0,1,0,0.5,0.5,1
data-raw/data/original/pre_lease/Pre-Lease - 2024-08-13T115332.679.xlsx,Station Nine,b2bl TF Side by Side,0,1,2755,1,0,1,0,0,0,1,0,1,1,0
data-raw/data/original/pre_lease/Pre-Lease - 2024-08-13T115332.679.xlsx,Station Nine,b2cl TF Side by Side,0,1,2705,1,0,1,0,0,0,1,0,1,1,0
data-raw/data/original/pre_lease/Pre-Lease - 2024-08-13T115332.679.xlsx,Station Nine,b3a 1F Courtyard Side by Side,0,4,2532.25,4,2,3,0,1,2,4,0.5,1,0.5,0
data-raw/data/original/pre_lease/Pre-Lease - 2024-08-13T115332.679.xlsx,Station Nine,b3a 1F Pool Side by Side,0,1,2399,1,1,0,0,1,1,1,1,1,0,0
data-raw/data/original/pre_lease/Pre-Lease - 2024-08-13T115332.679.xlsx,Station Nine,b3a 1F Side by Side,0,1,2590,1,0,1,0,0,0,1,0,1,1,0
data-raw/data/original/pre_lease/Pre-Lease - 2024-08-13T115332.679.xlsx,Station Nine,b3a Courtyard Side by Side,0,4,2564.75,3,3,2,0,2,3,4,0.75,1,0.25,0
data-raw/data/original/pre_lease/Pre-Lease - 2024-08-13T115332.679.xlsx,Station Nine,b3a Pool Side by Side,0,2,2548,2,1,0,1,2,2,2,1,1,0,0
data-raw/data/original/pre_lease/Pre-Lease - 2024-08-13T115332.679.xlsx,Station Nine,b3a Side by Side,0,4,2432.5,4,1,4,1,0,2,4,0.5,1,0.5,0
data-raw/data/original/pre_lease/Pre-Lease - 2024-08-13T115332.679.xlsx,Station Nine,b3a TF Courtyard Side by Side,0,2,2530,2,2,2,0,0,2,2,1,1,0,0
data-raw/data/original/pre_lease/Pre-Lease - 2024-08-13T115332.679.xlsx,Station Nine,b3a TF Pool Side by Side,0,1,2569,1,0,0,1,1,1,1,1,1,0,0
data-raw/data/original/pre_lease/Pre-Lease - 2024-08-13T115332.679.xlsx,Station Nine,b3a TF Side by Side,0,2,2548,2,0,0,1,2,1,2,0.5,1,0.5,0
data-raw/data/original/pre_lease/Pre-Lease - 2024-08-13T115332.679.xlsx,Station Nine,b3b Courtyard Side by Side,0,4,2598.25,4,4,4,0,0,4,4,1,1,0,0
data-raw/data/original/pre_lease/Pre-Lease - 2024-08-13T115332.679.xlsx,Station Nine,b3b TF Courtyard Side by Side,0,2,2555,2,2,2,0,0,2,2,1,1,0,0
data-raw/data/original/pre_lease/Pre-Lease - 2024-08-13T115332.679.xlsx,Station Nine,b4 1F Pool Side by Side,0,1,0,0,0,0,1,0,1,0,1,0,-1,1
data-raw/data/original/pre_lease/Pre-Lease - 2024-08-13T115332.679.xlsx,Station Nine,b4 Pool Side by Side,0,2,2540,1,0,1,2,1,2,2,1,1,0,0
data-raw/data/original/pre_lease/Pre-Lease - 2024-08-13T115332.679.xlsx,Station Nine,b4 TF Pool Side by Side,0,1,2782,1,0,1,0,0,0,1,0,1,1,0
data-raw/data/original/pre_lease/Pre-Lease - 2024-08-13T115332.679.xlsx,Station Nine,b5 Pool Side by Side,0,1,3045,1,1,0,0,1,1,1,1,1,0,0
data-raw/data/original/pre_lease/Pre-Lease - 2024-08-13T115332.679.xlsx,Station Nine,b5 TF Pool Side by Side,0,1,2850,1,0,1,1,0,1,1,1,1,0,0
data-raw/data/original/pre_lease/Pre-Lease - 2024-08-13T115332.679.xlsx,Station Nine,b7hc Side by Side,0,1,3146,1,1,1,0,0,1,1,1,1,0,0
data-raw/data/original/pre_lease/Pre-Lease - 2024-08-13T115332.679.xlsx,Station Nine,b7hc TF Side by Side,0,1,3081,1,0,0,1,1,1,1,1,1,0,0
data-raw/data/original/pre_lease/Pre-Lease - 2024-08-13T115332.679.xlsx,Station Nine,b8 Side by Side,0,1,0,0,0,0,1,0,1,0,1,0,-1,1
data-raw/data/original/pre_lease/Pre-Lease - 2024-08-13T115332.679.xlsx,Station Nine,b8 TF Side by Side,0,1,2970,0,0,1,1,0,1,1,1,1,0,0
data-raw/data/original/pre_lease/Pre-Lease - 2024-08-13T115332.679.xlsx,Station Nine,Not Selected,0,0,0,0,0,0,0,0,0,0,0,0,0,0
data-raw/data/original/pre_lease/Pre-Lease - 2024-08-13T115332.679.xlsx,The Academy At Frisco,A1,0,31,1413.75,18,19,17,12,15,31,32,1,1.032258064516129,0.032258064516129004,-1
data-raw/data/original/pre_lease/Pre-Lease - 2024-08-13T115332.679.xlsx,The Academy At Frisco,A2,0,3,1481.6666666666667,1,2,1,1,2,3,3,1,1,0,0
data-raw/data/original/pre_lease/Pre-Lease - 2024-08-13T115332.679.xlsx,The Academy At Frisco,B1,0,48,959.7916666666666,29,24,15,22,33,46,48,0.9583333333333334,1,0.04166666666666663,0
data-raw/data/original/pre_lease/Pre-Lease - 2024-08-13T115332.679.xlsx,The Academy At Frisco,B2,0,10,969.5,2,7,7,3,3,10,10,1,1,0,0
data-raw/data/original/pre_lease/Pre-Lease - 2024-08-13T115332.679.xlsx,The Academy At Frisco,B3,0,10,721.6666666666666,2,9,10,1,2,10,12,1,1.2,0.19999999999999996,-2
data-raw/data/original/pre_lease/Pre-Lease - 2024-08-13T115332.679.xlsx,The Academy At Frisco,C1,0,18,919.7222222222222,5,12,10,6,8,18,18,1,1,0,0
data-raw/data/original/pre_lease/Pre-Lease - 2024-08-13T115332.679.xlsx,The Academy At Frisco,D1,0,228,867.6855895196506,109,136,128,88,101,224,229,0.9824561403508771,1.0043859649122806,0.021929824561403466,-1
data-raw/data/original/pre_lease/Pre-Lease - 2024-08-13T115332.679.xlsx,The Academy At Frisco,D2,0,140,831.0357142857143,89,80,53,59,87,139,140,0.9928571428571429,1,0.0071428571428571175,0
data-raw/data/original/pre_lease/Pre-Lease - 2024-08-13T115332.679.xlsx,The Academy At Frisco,D3,0,16,832.125,8,5,7,8,9,13,16,0.8125,1,0.1875,0
data-raw/data/original/pre_lease/Pre-Lease - 2024-08-13T115332.679.xlsx,The Academy At Frisco,D4,0,40,859.1,22,21,18,19,22,40,40,1,1,0,0
data-raw/data/original/pre_lease/Pre-Lease - 2024-08-13T115332.679.xlsx,The Academy At Frisco,D5,0,76,855.6315789473684,30,39,46,31,30,70,76,0.9210526315789473,1,0.07894736842105265,0
data-raw/data/original/pre_lease/Pre-Lease - 2024-08-13T115332.679.xlsx,The Academy At Frisco,Not Selected,0,0,0,0,0,0,0,0,0,0,0,0,0,0
data-raw/data/original/pre_lease/Pre-Lease - 2024-08-13T115332.679.xlsx,The Academy At Frisco,Studio,0,20,1282.5,7,13,13,7,7,20,20,1,1,0,0
data-raw/data/original/pre_lease/Pre-Lease - 2024-08-13T115332.679.xlsx,The Academy On Charles,A1,0,1,2000,1,1,0,0,1,1,1,1,1,0,0
data-raw/data/original/pre_lease/Pre-Lease - 2024-08-13T115332.679.xlsx,The Academy On Charles,A2,0,1,2175,1,1,0,0,1,1,1,1,1,0,0
data-raw/data/original/pre_lease/Pre-Lease - 2024-08-13T115332.679.xlsx,The Academy On Charles,B1,0,10,1574,3,5,7,5,3,10,10,1,1,0,0
data-raw/data/original/pre_lease/Pre-Lease - 2024-08-13T115332.679.xlsx,The Academy On Charles,B2,0,8,1596.25,8,5,0,3,8,8,8,1,1,0,0
data-raw/data/original/pre_lease/Pre-Lease - 2024-08-13T115332.679.xlsx,The Academy On Charles,B3,0,6,1558.3333333333333,0,3,6,3,0,6,6,1,1,0,0
data-raw/data/original/pre_lease/Pre-Lease - 2024-08-13T115332.679.xlsx,The Academy On Charles,B4,0,8,1601.25,4,8,3,0,5,8,8,1,1,0,0
data-raw/data/original/pre_lease/Pre-Lease - 2024-08-13T115332.679.xlsx,The Academy On Charles,B5,0,8,1177.75,3,4,6,4,2,8,8,1,1,0,0
data-raw/data/original/pre_lease/Pre-Lease - 2024-08-13T115332.679.xlsx,The Academy On Charles,B6,0,10,1577,2,10,8,0,2,10,10,1,1,0,0
data-raw/data/original/pre_lease/Pre-Lease - 2024-08-13T115332.679.xlsx,The Academy On Charles,C1,0,12,1460,6,4,6,8,6,12,12,1,1,0,0
data-raw/data/original/pre_lease/Pre-Lease - 2024-08-13T115332.679.xlsx,The Academy On Charles,C2,0,36,1528.888888888889,17,29,21,6,15,35,36,0.9722222222222222,1,0.02777777777777779,0
data-raw/data/original/pre_lease/Pre-Lease - 2024-08-13T115332.679.xlsx,The Academy On Charles,C3,0,24,1442.0833333333333,11,14,12,10,12,24,24,1,1,0,0
data-raw/data/original/pre_lease/Pre-Lease - 2024-08-13T115332.679.xlsx,The Academy On Charles,C4,0,3,1470,3,3,0,0,3,3,3,1,1,0,0
data-raw/data/original/pre_lease/Pre-Lease - 2024-08-13T115332.679.xlsx,The Academy On Charles,D1,0,104,1447.7884615384614,31,69,73,35,31,104,104,1,1,0,0
data-raw/data/original/pre_lease/Pre-Lease - 2024-08-13T115332.679.xlsx,The Academy On Charles,D2,0,40,1483.5,12,20,27,20,13,40,40,1,1,0,0
data-raw/data/original/pre_lease/Pre-Lease - 2024-08-13T115332.679.xlsx,The Academy On Charles,D3,0,20,1424,6,18,13,2,7,20,20,1,1,0,0
data-raw/data/original/pre_lease/Pre-Lease - 2024-08-13T115332.679.xlsx,The Academy On Charles,D4,0,32,1249.6875,11,19,21,13,11,32,32,1,1,0,0
data-raw/data/original/pre_lease/Pre-Lease - 2024-08-13T115332.679.xlsx,The Academy On Charles,Not Selected,0,0,0,0,0,0,0,0,0,0,0,0,0,0
data-raw/data/original/pre_lease/Pre-Lease - 2024-08-13T115332.679.xlsx,The Academy On Charles,S1,0,4,1970,4,1,0,3,4,4,4,1,1,0,0
data-raw/data/original/pre_lease/Pre-Lease - 2024-08-13T115332.679.xlsx,The Academy On Charles,S2,0,1,2365,1,0,0,1,1,1,1,1,1,0,0
data-raw/data/original/pre_lease/Pre-Lease - 2024-08-13T115332.679.xlsx,The Caswell At Runnymeade,A1.1,0,3,2413.3333333333335,3,0,3,0,0,0,3,0,1,1,0
data-raw/data/original/pre_lease/Pre-Lease - 2024-08-13T115332.679.xlsx,The Caswell At Runnymeade,A1.2,0,2,2555,2,1,1,0,0,1,1,0.5,0.5,0,1
data-raw/data/original/pre_lease/Pre-Lease - 2024-08-13T115332.679.xlsx,The Caswell At Runnymeade,A2,0,4,2619.6666666666665,4,3,1,0,2,3,3,0.75,0.75,0,1
data-raw/data/original/pre_lease/Pre-Lease - 2024-08-13T115332.679.xlsx,The Caswell At Runnymeade,A3,0,16,2280.230769230769,14,6,9,0,4,6,13,0.375,0.8125,0.4375,3
data-raw/data/original/pre_lease/Pre-Lease - 2024-08-13T115332.679.xlsx,The Caswell At Runnymeade,A4,0,16,2389.5384615384614,15,4,13,0,0,4,13,0.25,0.8125,0.5625,3
data-raw/data/original/pre_lease/Pre-Lease - 2024-08-13T115332.679.xlsx,The Caswell At Runnymeade,A5.1,0,6,2760.4,6,3,4,0,1,3,5,0.5,0.8333333333333334,0.33333333333333337,1
data-raw/data/original/pre_lease/Pre-Lease - 2024-08-13T115332.679.xlsx,The Caswell At Runnymeade,A5.2,0,6,2744.6666666666665,6,1,5,0,1,1,6,0.16666666666666666,1,0.8333333333333334,0
data-raw/data/original/pre_lease/Pre-Lease - 2024-08-13T115332.679.xlsx,The Caswell At Runnymeade,A6,0,4,2767.25,4,0,4,0,0,0,4,0,1,1,0
data-raw/data/original/pre_lease/Pre-Lease - 2024-08-13T115332.679.xlsx,The Caswell At Runnymeade,A7,0,8,2946.875,8,0,7,0,1,0,8,0,1,1,0
data-raw/data/original/pre_lease/Pre-Lease - 2024-08-13T115332.679.xlsx,The Caswell At Runnymeade,B1,2,83,3144.3333333333335,54,11,49,0,5,11,54,0.13253012048192772,0.6506024096385542,0.5180722891566265,29
data-raw/data/original/pre_lease/Pre-Lease - 2024-08-13T115332.679.xlsx,The Caswell At Runnymeade,B1.2,0,7,3273.3333333333335,6,1,5,0,1,1,6,0.14285714285714285,0.8571428571428571,0.7142857142857142,1
data-raw/data/original/pre_lease/Pre-Lease - 2024-08-13T115332.679.xlsx,The Caswell At Runnymeade,B2,0,38,3337.0416666666665,23,2,23,0,1,2,24,0.05263157894736842,0.631578947368421,0.5789473684210527,14
data-raw/data/original/pre_lease/Pre-Lease - 2024-08-13T115332.679.xlsx,The Caswell At Runnymeade,B3.1,0,4,3556.5,1,0,2,0,0,0,2,0,0.5,0.5,2
data-raw/data/original/pre_lease/Pre-Lease - 2024-08-13T115332.679.xlsx,The Caswell At Runnymeade,B3.3,0,2,0,1,2,0,0,0,2,0,1,0,-1,2
data-raw/data/original/pre_lease/Pre-Lease - 2024-08-13T115332.679.xlsx,The Caswell At Runnymeade,C1,0,16,3269.181818181818,11,0,11,0,0,0,11,0,0.6875,0.6875,5
data-raw/data/original/pre_lease/Pre-Lease - 2024-08-13T115332.679.xlsx,The Caswell At Runnymeade,C2,0,32,4007.5925925925926,27,4,25,0,2,4,27,0.125,0.84375,0.71875,5
data-raw/data/original/pre_lease/Pre-Lease - 2024-08-13T115332.679.xlsx,The Caswell At Runnymeade,Not Selected,0,0,0,0,0,0,0,0,0,0,0,0,0,0
data-raw/data/original/pre_lease/Pre-Lease - 2024-08-13T115332.679.xlsx,The Dean Campustown,A1,0,14,1963.2142857142858,9,10,5,4,9,14,14,1,1,0,0
data-raw/data/original/pre_lease/Pre-Lease - 2024-08-13T115332.679.xlsx,The Dean Campustown,A2 Deluxe,0,28,976.7857142857143,10,16,16,10,12,26,28,0.9285714285714286,1,0.0714285714285714,0
data-raw/data/original/pre_lease/Pre-Lease - 2024-08-13T115332.679.xlsx,The Dean Campustown,B1,0,28,1247.6785714285713,9,19,17,9,11,28,28,1,1,0,0
data-raw/data/original/pre_lease/Pre-Lease - 2024-08-13T115332.679.xlsx,The Dean Campustown,B2,0,28,1316.7241379310344,12,19,17,9,12,28,29,1,1.0357142857142858,0.03571428571428581,-1
data-raw/data/original/pre_lease/Pre-Lease - 2024-08-13T115332.679.xlsx,The Dean Campustown,B3 XL,0,56,756.1111111111111,12,44,40,12,14,56,54,1,0.9642857142857143,-0.0357142857142857,2
data-raw/data/original/pre_lease/Pre-Lease - 2024-08-13T115332.679.xlsx,The Dean Campustown,B4 XL,0,56,780.5357142857143,34,36,16,14,40,50,56,0.8928571428571429,1,0.1071428571428571,0
data-raw/data/original/pre_lease/Pre-Lease - 2024-08-13T115332.679.xlsx,The Dean Campustown,D1,0,56,1041.888888888889,13,44,32,9,13,53,45,0.9464285714285714,0.8035714285714286,-0.1428571428571428,11
data-raw/data/original/pre_lease/Pre-Lease - 2024-08-13T115332.679.xlsx,The Dean Campustown,D2,0,56,943.8181818181819,7,35,48,16,7,51,55,0.9107142857142857,0.9821428571428571,0.0714285714285714,1
data-raw/data/original/pre_lease/Pre-Lease - 2024-08-13T115332.679.xlsx,The Dean Campustown,D3,0,56,1058.9454545454546,21,42,33,13,22,55,55,0.9821428571428571,0.9821428571428571,0,1
data-raw/data/original/pre_lease/Pre-Lease - 2024-08-13T115332.679.xlsx,The Dean Campustown,D4,0,56,1119.298245614035,17,43,40,11,17,54,57,0.9642857142857143,1.0178571428571428,0.05357142857142849,-1
data-raw/data/original/pre_lease/Pre-Lease - 2024-08-13T115332.679.xlsx,The Dean Campustown,D5,0,56,1147.3214285714287,21,32,34,24,22,56,56,1,1,0,0
data-raw/data/original/pre_lease/Pre-Lease - 2024-08-13T115332.679.xlsx,The Dean Campustown,M1,0,84,1606.1904761904761,29,45,46,36,38,81,84,0.9642857142857143,1,0.0357142857142857,0
data-raw/data/original/pre_lease/Pre-Lease - 2024-08-13T115332.679.xlsx,The Dean Campustown,Not Selected,0,0,0,0,0,0,0,0,0,0,0,0,0,0
data-raw/data/original/pre_lease/Pre-Lease - 2024-08-13T115332.679.xlsx,The Dean Campustown,S1,0,42,1808.095238095238,20,21,21,22,21,43,42,1.0238095238095237,1,-0.023809523809523725,0
data-raw/data/original/pre_lease/Pre-Lease - 2024-08-13T115332.679.xlsx,The Dean Campustown,S2,0,28,1828.392857142857,8,15,16,12,12,27,28,0.9642857142857143,1,0.0357142857142857,0
data-raw/data/original/pre_lease/Pre-Lease - 2024-08-13T115332.679.xlsx,The Dean Campustown,S3 XL,0,28,1002.6785714285714,14,16,8,12,20,28,28,1,1,0,0
data-raw/data/original/pre_lease/Pre-Lease - 2024-08-13T115332.679.xlsx,The Dean Reno,A1,0,1,2400,0,1,1,0,0,1,1,1,1,0,0
data-raw/data/original/pre_lease/Pre-Lease - 2024-08-13T115332.679.xlsx,The Dean Reno,B1,0,36,1349.090909090909,12,34,20,0,13,34,33,0.9444444444444444,0.9166666666666666,-0.02777777777777779,3
data-raw/data/original/pre_lease/Pre-Lease - 2024-08-13T115332.679.xlsx,The Dean Reno,B2,0,34,1459.1176470588234,17,31,18,0,16,31,34,0.9117647058823529,1,0.08823529411764708,0
data-raw/data/original/pre_lease/Pre-Lease - 2024-08-13T115332.679.xlsx,The Dean Reno,C1,0,3,1405,2,3,1,0,1,3,2,1,0.6666666666666666,-0.33333333333333337,1
data-raw/data/original/pre_lease/Pre-Lease - 2024-08-13T115332.679.xlsx,The Dean Reno,D1,0,180,1016.4342105263158,57,90,92,0,60,90,152,0.5,0.8444444444444444,0.34444444444444444,28
data-raw/data/original/pre_lease/Pre-Lease - 2024-08-13T115332.679.xlsx,The Dean Reno,D2,0,140,992,24,76,80,0,32,76,112,0.5428571428571428,0.8,0.25714285714285723,28
data-raw/data/original/pre_lease/Pre-Lease - 2024-08-13T115332.679.xlsx,The Dean Reno,D3,0,64,980.7916666666666,15,16,32,0,16,16,48,0.25,0.75,0.5,16
data-raw/data/original/pre_lease/Pre-Lease - 2024-08-13T115332.679.xlsx,The Dean Reno,D4,0,45,938.2592592592592,5,24,21,0,6,24,27,0.5333333333333333,0.6,0.06666666666666665,18
data-raw/data/original/pre_lease/Pre-Lease - 2024-08-13T115332.679.xlsx,The Dean Reno,D5,0,36,936.4827586206897,18,28,10,0,19,28,29,0.7777777777777778,0.8055555555555556,0.02777777777777779,7
data-raw/data/original/pre_lease/Pre-Lease - 2024-08-13T115332.679.xlsx,The Dean Reno,E1,0,90,893.2236842105264,22,82,53,0,23,82,76,0.9111111111111111,0.8444444444444444,-0.06666666666666665,14
data-raw/data/original/pre_lease/Pre-Lease - 2024-08-13T115332.679.xlsx,The Dean Reno,E1 Alt,0,45,897.78125,12,33,19,0,13,33,32,0.7333333333333333,0.7111111111111111,-0.022222222222222143,13
data-raw/data/original/pre_lease/Pre-Lease - 2024-08-13T115332.679.xlsx,The Dean Reno,E2,0,54,709.6363636363636,20,49,24,0,20,49,44,0.9074074074074074,0.8148148148148148,-0.09259259259259267,10
data-raw/data/original/pre_lease/Pre-Lease - 2024-08-13T115332.679.xlsx,The Dean Reno,E3,0,45,869.3846153846154,6,40,33,0,6,40,39,0.8888888888888888,0.8666666666666667,-0.022222222222222143,6
data-raw/data/original/pre_lease/Pre-Lease - 2024-08-13T115332.679.xlsx,The Dean Reno,Not Selected,0,0,0,0,0,0,0,0,0,0,0,0,0,0
data-raw/data/original/pre_lease/Pre-Lease - 2024-08-13T115332.679.xlsx,The Rise At Northgate,A1,0,36,1821.5277777777778,32,16,8,20,28,36,36,1,1,0,0
data-raw/data/original/pre_lease/Pre-Lease - 2024-08-13T115332.679.xlsx,The Rise At Northgate,A2,0,4,1758.3333333333333,3,0,2,4,1,4,3,1,0.75,-0.25,1
data-raw/data/original/pre_lease/Pre-Lease - 2024-08-13T115332.679.xlsx,The Rise At Northgate,A3,0,1,2425,1,0,1,1,0,1,1,1,1,0,0
data-raw/data/original/pre_lease/Pre-Lease - 2024-08-13T115332.679.xlsx,The Rise At Northgate,B1,0,42,1201.7857142857142,34,9,15,34,27,43,42,1.0238095238095237,1,-0.023809523809523725,0
data-raw/data/original/pre_lease/Pre-Lease - 2024-08-13T115332.679.xlsx,The Rise At Northgate,B2,0,4,1405,4,0,2,4,2,4,4,1,1,0,0
data-raw/data/original/pre_lease/Pre-Lease - 2024-08-13T115332.679.xlsx,The Rise At Northgate,B3,0,2,1425,2,0,0,2,2,2,2,1,1,0,0
data-raw/data/original/pre_lease/Pre-Lease - 2024-08-13T115332.679.xlsx,The Rise At Northgate,C1,0,3,1173.3333333333333,3,0,0,3,3,3,3,1,1,0,0
data-raw/data/original/pre_lease/Pre-Lease - 2024-08-13T115332.679.xlsx,The Rise At Northgate,D1,0,252,1030.595238095238,205,111,120,140,132,251,252,0.996031746031746,1,0.003968253968253954,0
data-raw/data/original/pre_lease/Pre-Lease - 2024-08-13T115332.679.xlsx,The Rise At Northgate,D2,0,4,1058.75,4,1,2,3,2,4,4,1,1,0,0
data-raw/data/original/pre_lease/Pre-Lease - 2024-08-13T115332.679.xlsx,The Rise At Northgate,D3,0,40,1029,32,15,18,23,22,38,40,0.95,1,0.050000000000000044,0
data-raw/data/original/pre_lease/Pre-Lease - 2024-08-13T115332.679.xlsx,The Rise At Northgate,E1,0,15,899,13,7,6,8,9,15,15,1,1,0,0
data-raw/data/original/pre_lease/Pre-Lease - 2024-08-13T115332.679.xlsx,The Rise At Northgate,E2,0,30,914.5,28,14,9,16,21,30,30,1,1,0,0
data-raw/data/original/pre_lease/Pre-Lease - 2024-08-13T115332.679.xlsx,The Rise At Northgate,E3,0,5,888,4,2,1,3,4,5,5,1,1,0,0
data-raw/data/original/pre_lease/Pre-Lease - 2024-08-13T115332.679.xlsx,The Rise At Northgate,F1,0,6,827.5,6,0,4,6,2,6,6,1,1,0,0
data-raw/data/original/pre_lease/Pre-Lease - 2024-08-13T115332.679.xlsx,The Rise At Northgate,S1,0,21,1640.7142857142858,18,11,11,10,10,21,21,1,1,0,0
data-raw/data/original/pre_lease/Pre-Lease - 2024-08-13T115332.679.xlsx,Torre,A1,0,3,2888.3333333333335,1,2,2,2,1,4,3,1.3333333333333333,1,-0.33333333333333326,0
data-raw/data/original/pre_lease/Pre-Lease - 2024-08-13T115332.679.xlsx,Torre,A2,0,1,2815,1,1,0,0,1,1,1,1,1,0,0
data-raw/data/original/pre_lease/Pre-Lease - 2024-08-13T115332.679.xlsx,Torre,B1,0,2,1750,0,0,2,2,0,2,2,1,1,0,0
data-raw/data/original/pre_lease/Pre-Lease - 2024-08-13T115332.679.xlsx,Torre,B2,0,10,1845,1,5,9,5,1,10,10,1,1,0,0
data-raw/data/original/pre_lease/Pre-Lease - 2024-08-13T115332.679.xlsx,Torre,B3,0,4,1928.75,1,4,3,0,1,4,4,1,1,0,0
data-raw/data/original/pre_lease/Pre-Lease - 2024-08-13T115332.679.xlsx,Torre,B4,0,2,1985,1,0,1,2,1,2,2,1,1,0,0
data-raw/data/original/pre_lease/Pre-Lease - 2024-08-13T115332.679.xlsx,Torre,B5 - SHARED,0,44,997.2727272727273,11,31,33,8,11,39,44,0.8863636363636364,1,0.11363636363636365,0
data-raw/data/original/pre_lease/Pre-Lease - 2024-08-13T115332.679.xlsx,Torre,B5.2 DELUXE,0,12,857.5,4,5,2,6,4,11,6,0.9166666666666666,0.5,-0.41666666666666663,6
data-raw/data/original/pre_lease/Pre-Lease - 2024-08-13T115332.679.xlsx,Torre,B6 DELUXE,0,36,892.8571428571429,8,26,18,5,10,31,28,0.8611111111111112,0.7777777777777778,-0.08333333333333337,8
data-raw/data/original/pre_lease/Pre-Lease - 2024-08-13T115332.679.xlsx,Torre,B7 - SEMI-SHARED,0,12,930.625,1,11,8,0,0,11,8,0.9166666666666666,0.6666666666666666,-0.25,4
data-raw/data/original/pre_lease/Pre-Lease - 2024-08-13T115332.679.xlsx,Torre,B8 DELUXE,0,28,920,4,19,8,4,6,23,14,0.8214285714285714,0.5,-0.3214285714285714,14
data-raw/data/original/pre_lease/Pre-Lease - 2024-08-13T115332.679.xlsx,Torre,B9 - SHARED,0,24,979.5833333333334,6,17,18,7,6,24,24,1,1,0,0
data-raw/data/original/pre_lease/Pre-Lease - 2024-08-13T115332.679.xlsx,Torre,C1,0,3,1541.6666666666667,1,3,2,0,1,3,3,1,1,0,0
data-raw/data/original/pre_lease/Pre-Lease - 2024-08-13T115332.679.xlsx,Torre,C2 - SEMI-SHARED,0,16,1323.6363636363637,1,11,8,2,3,13,11,0.8125,0.6875,-0.125,5
data-raw/data/original/pre_lease/Pre-Lease - 2024-08-13T115332.679.xlsx,Torre,C3,0,21,1659.2857142857142,9,11,13,10,8,21,21,1,1,0,0
data-raw/data/original/pre_lease/Pre-Lease - 2024-08-13T115332.679.xlsx,Torre,D1,0,28,1528.2857142857142,3,23,17,4,4,27,21,0.9642857142857143,0.75,-0.2142857142857143,7
data-raw/data/original/pre_lease/Pre-Lease - 2024-08-13T115332.679.xlsx,Torre,D2 - SEMI-SHARED,0,5,1650.25,5,1,4,4,0,5,4,1,0.8,-0.19999999999999996,1
data-raw/data/original/pre_lease/Pre-Lease - 2024-08-13T115332.679.xlsx,Torre,D3 - SEMI-SHARED,0,12,1428.4444444444443,0,6,7,0,2,6,9,0.5,0.75,0.25,3
data-raw/data/original/pre_lease/Pre-Lease - 2024-08-13T115332.679.xlsx,Torre,D4 - SEMI-SHARED,0,12,1329.75,0,7,5,0,3,7,8,0.5833333333333334,0.6666666666666666,0.08333333333333326,4
data-raw/data/original/pre_lease/Pre-Lease - 2024-08-13T115332.679.xlsx,Torre,Not Selected,0,0,0,0,0,0,0,0,0,0,0,0,0,0
data-raw/data/original/pre_lease/Pre-Lease - 2024-08-13T115332.679.xlsx,Torre,S1,0,1,1145,1,0,0,1,1,1,1,1,1,0,0
data-raw/data/original/pre_lease/Pre-Lease - 2024-08-13T115332.679.xlsx,Torre,S2,0,14,1231.4285714285713,9,2,6,12,8,14,14,1,1,0,0
data-raw/data/original/pre_lease/Pre-Lease - 2024-08-13T115332.679.xlsx,Torre,TH - C1,0,6,1564.1666666666667,5,5,0,1,6,6,6,1,1,0,0
data-raw/data/original/pre_lease/Pre-Lease - 2024-08-13T115332.679.xlsx,Torre,TH - C2,0,6,1433.3333333333333,4,5,2,1,4,6,6,1,1,0,0
data-raw/data/original/pre_lease/Pre-Lease - 2024-08-13T115332.679.xlsx,Torre,TH - C3,0,3,1795,0,1,3,2,0,3,3,1,1,0,0
data-raw/data/original/pre_lease/Pre-Lease - 2024-08-13T115332.679.xlsx,Torre,TH - C3.1,0,3,1733.3333333333333,2,1,1,2,2,3,3,1,1,0,0
data-raw/data/original/pre_lease/Pre-Lease - 2024-08-13T115332.679.xlsx,Torre,TH - C4,0,12,1559.5833333333333,2,8,10,4,2,12,12,1,1,0,0
data-raw/data/original/pre_lease/Pre-Lease - 2024-08-13T115332.679.xlsx,Torre,TH - D1,0,56,1514.4642857142858,10,39,46,16,10,55,56,0.9821428571428571,1,0.017857142857142905,0
data-raw/data/original/pre_lease/Pre-Lease - 2024-08-13T115332.679.xlsx,Torre,TH - D1.2,0,32,1444.8125,9,21,24,5,8,26,32,0.8125,1,0.1875,0
data-raw/data/original/pre_lease/Pre-Lease - 2024-08-13T115332.679.xlsx,Torre,TH - D2,0,8,1491.75,4,5,3,3,5,8,8,1,1,0,0
data-raw/data/original/pre_lease/Pre-Lease - 2024-08-13T115332.679.xlsx,Torre,TH - D3,0,4,1583.75,4,4,0,0,4,4,4,1,1,0,0
data-raw/data/original/pre_lease/Pre-Lease - 2024-08-13T115332.679.xlsx,Torre,TH - D4 - SEMI-SHARED,0,10,1343,1,9,10,1,0,10,10,1,1,0,0
data-raw/data/original/pre_lease/Pre-Lease - 2024-08-13T115332.679.xlsx,Torre,TH - D5,0,16,1494.6875,8,9,7,6,9,15,16,0.9375,1,0.0625,0
data-raw/data/original/pre_lease/Pre-Lease - 2024-08-13T115332.679.xlsx,Torre,TH - D6 - SEMI-SHARED,0,15,1506.25,9,9,4,5,8,14,12,0.9333333333333333,0.8,-0.1333333333333333,3
data-raw/data/original/pre_lease/Pre-Lease - 2024-08-13T115332.679.xlsx,Torre,TH - D8 - SEMI-SHARED,0,6,0,1,3,1,0,5,3,6,0.5,1,0.5,0
data-raw/data/original/pre_lease/Pre-Lease - 2024-08-13T115332.679.xlsx,Torre,TH - D9,0,15,1507,4,8,11,7,4,15,15,1,1,0,0
data-raw/data/original/pre_lease/Pre-Lease - 2024-08-13T115332.679.xlsx,Torre,TH - E1,0,10,1583,0,2,10,2,0,4,10,0.4,1,0.6,0
data-raw/data/original/pre_lease/Pre-Lease - 2024-08-13T115332.679.xlsx,Torre,TH - F1,0,18,1637.5,7,9,13,8,5,17,18,0.9444444444444444,1,0.05555555555555558,0
data-raw/data/original/pre_lease/Pre-Lease - 2024-08-13T115332.679.xlsx,Torre,TH - F2,0,6,1769.1666666666667,1,6,6,0,0,6,6,1,1,0,0
data-raw/data/original/pre_lease/Pre-Lease - 2024-08-13T115332.679.xlsx,Torre,TH - F3,0,6,1589,0,4,5,0,0,4,5,0.6666666666666666,0.8333333333333334,0.16666666666666674,1
data-raw/data/original/pre_lease/Pre-Lease - 2024-08-13T115332.679.xlsx,Torre,TH - F4,0,18,1517.8125,1,10,15,6,1,16,16,0.8888888888888888,0.8888888888888888,0,2
data-raw/data/original/pre_lease/Pre-Lease - 2024-08-13T115332.679.xlsx,Torre,TH - F5,0,18,1553.125,6,12,10,5,6,17,16,0.9444444444444444,0.8888888888888888,-0.05555555555555558,2
data-raw/data/original/pre_lease/Pre-Lease - 2024-08-13T115332.679.xlsx,Venue At North Campus,A,0,6,1690.6666666666667,3,1,3,4,3,5,6,0.8333333333333334,1,0.16666666666666663,0
data-raw/data/original/pre_lease/Pre-Lease - 2024-08-13T115332.679.xlsx,Venue At North Campus,B,0,96,1143.7894736842106,42,50,53,43,42,93,95,0.96875,0.9895833333333334,0.02083333333333337,1
data-raw/data/original/pre_lease/Pre-Lease - 2024-08-13T115332.679.xlsx,Venue At North Campus,D1,0,256,970.5833333333334,96,163,116,87,100,250,216,0.9765625,0.84375,-0.1328125,40
data-raw/data/original/pre_lease/Pre-Lease - 2024-08-13T115332.679.xlsx,Venue At North Campus,D2,0,64,986.3636363636364,19,39,35,25,20,64,55,1,0.859375,-0.140625,9
data-raw/data/original/pre_lease/Pre-Lease - 2024-08-13T115332.679.xlsx,Venue At North Campus,D3,0,192,963.0266666666666,83,134,65,58,85,192,150,1,0.78125,-0.21875,42
data-raw/data/original/pre_lease/Pre-Lease - 2024-08-13T115332.679.xlsx,Venue At North Campus,E,0,120,1009.8613445378152,48,70,72,49,47,119,119,0.9916666666666667,0.9916666666666667,0,1
data-raw/data/original/pre_lease/Pre-Lease - 2024-08-13T115332.679.xlsx,Venue At North Campus,Not Selected,0,0,0,0,0,0,0,0,0,0,0,0,0,0
